....................
....................
....................
....................
....................
......#####.........
....................
....................
......#.............
......#.............
......#.............
......#.............
......#######.......
....................
....................