....................
....................
...........#........
...........#........
......######........
......#.............
......#.............
......####..........
....................
....................
......#....######...
......#.............
......#.............
......#.............
......#######.......